time,Bronx,Brooklyn,Manhattan,Queens,Staten Island,Allowed,Bronx Pct,Brooklyn Pct,Manhattan Pct,Queens Pct,Staten Island Pct,Free,Metered,No,Total,Free Pct,Metered Pct,No Pct
Mon 00:00,220278,451414,115355,679761,240726,1707534,0.129003581,0.264366039,0.067556488,0.398095148,0.140978745,1707534,0,818924,2526458,0.67586083,0,0.32413917
Mon 00:30,220278,451414,115355,679761,240726,1707534,0.129003581,0.264366039,0.067556488,0.398095148,0.140978745,1707534,0,818924,2526458,0.67586083,0,0.32413917
Mon 01:00,220278,451404,115130,679761,240726,1707299,0.129021337,0.26439657,0.067434,0.398149943,0.14099815,1707299,0,819159,2526458,0.675767814,0,0.324232186
Mon 01:30,220278,451404,115130,679761,240726,1707299,0.129021337,0.26439657,0.067434,0.398149943,0.14099815,1707299,0,819159,2526458,0.675767814,0,0.324232186
Mon 02:00,220278,450985,114764,679710,240726,1706463,0.129084545,0.264280562,0.067252557,0.398315111,0.141067225,1706463,0,819995,2526458,0.675436916,0,0.324563084
Mon 02:30,220278,450985,114764,679710,240726,1706463,0.129084545,0.264280562,0.067252557,0.398315111,0.141067225,1706463,0,819995,2526458,0.675436916,0,0.324563084
Mon 03:00,221017,457220,114802,679961,240726,1713726,0.128968692,0.266798776,0.066989705,0.396773463,0.140469363,1713726,0,812732,2526458,0.678311692,0,0.321688308
Mon 03:30,221017,457220,114802,679961,240726,1713726,0.128968692,0.266798776,0.066989705,0.396773463,0.140469363,1713726,0,812732,2526458,0.678311692,0,0.321688308
Mon 04:00,221001,457275,114787,679954,240726,1713743,0.128958076,0.266828223,0.066980288,0.396765443,0.14046797,1713743,0,812715,2526458,0.67831842,0,0.32168158
Mon 04:30,221001,457275,114686,679954,240726,1713642,0.128965677,0.26684395,0.066925297,0.396788828,0.140476249,1713642,0,812816,2526458,0.678278444,0,0.321721556
Mon 05:00,221151,457624,114659,680473,240721,1714628,0.128978997,0.266894043,0.066871065,0.396863343,0.140392552,1714628,0,811830,2526458,0.678668713,0,0.321331287
Mon 05:30,221151,457622,114513,680473,240721,1714480,0.128990131,0.266915916,0.06679168,0.396897602,0.140404671,1714480,0,811978,2526458,0.678610133,0,0.321389867
Mon 06:00,221896,459717,115142,681079,240651,1718485,0.129123036,0.267512955,0.06700204,0.396325252,0.140036718,1718485,0,807973,2526458,0.680195357,0,0.319804643
Mon 06:30,221900,459545,115148,680991,240665,1718249,0.129143099,0.267449595,0.067014734,0.396328472,0.1400641,1718249,0,808209,2526458,0.680101945,0,0.319898055
Mon 07:00,215697,443438,96101,667419,238014,1660669,0.129885606,0.267023712,0.057868847,0.401897669,0.143324166,1660078,591,865789,2526458,0.65707722,0.000233924,0.342688855
Mon 07:30,213083,439108,94261,664504,238022,1648978,0.129221251,0.266291,0.057163285,0.4029793,0.144345164,1647480,1498,877480,2526458,0.652090793,0.000592925,0.347316282
Mon 08:00,208354,420340,82855,659138,237812,1608499,0.129533186,0.261324378,0.051510756,0.409784526,0.147847154,1590579,17920,917959,2526458,0.629568748,0.007092934,0.363338318
Mon 08:30,202776,407408,80874,651550,237812,1580420,0.128305134,0.25778464,0.051172473,0.412263829,0.150473925,1549520,30900,946038,2526458,0.613317142,0.012230562,0.374452296
Mon 09:00,201485,398436,79040,654471,238493,1571925,0.128177235,0.253470108,0.050282297,0.416350017,0.151720343,1511581,60344,954533,2526458,0.598300467,0.023884822,0.377814711
Mon 09:30,197886,397507,77280,647335,238493,1558501,0.126972007,0.255057263,0.049586109,0.415357449,0.153027172,1497399,61102,967957,2526458,0.592687074,0.024184847,0.383128079
Mon 10:00,204650,415502,80698,656815,238508,1596173,0.128212919,0.260311382,0.050557176,0.411493616,0.149424906,1532251,63922,930285,2526458,0.606481881,0.025301034,0.368217085
Mon 10:30,207639,427740,84693,657917,238508,1616497,0.128449975,0.264609214,0.052392921,0.407001683,0.147546206,1552567,63930,909961,2526458,0.614523178,0.025304201,0.360172621
Mon 11:00,213940,426315,83224,662106,238508,1624093,0.13172891,0.262494204,0.051243371,0.407677393,0.146856122,1560109,63984,902365,2526458,0.617508385,0.025325574,0.35716604
Mon 11:30,201479,406960,80386,652833,238508,1580166,0.127504958,0.257542562,0.05087187,0.413142037,0.150938572,1516182,63984,946292,2526458,0.600121593,0.025325574,0.374552832
Mon 12:00,201487,403059,80425,653288,238508,1576767,0.127784891,0.255623691,0.051006268,0.414321203,0.151263947,1512643,64124,949691,2526458,0.598720818,0.025380988,0.375898194
Mon 12:30,202476,418334,84920,656534,238508,1600772,0.12648647,0.261332657,0.053049404,0.410135859,0.14899561,1536648,64124,925686,2526458,0.608222262,0.025380988,0.36639675
Mon 13:00,214967,437790,88276,666268,238508,1645809,0.130614792,0.26600292,0.053636844,0.404827049,0.144918396,1581426,64383,880649,2526458,0.625945889,0.025483503,0.348570608
Mon 13:30,214967,441834,88276,667029,238435,1650541,0.130240327,0.267690412,0.05348307,0.404127495,0.144458696,1586158,64383,875917,2526458,0.627818867,0.025483503,0.34669763
Mon 14:00,214969,442891,88160,667040,238421,1651481,0.130167407,0.268178078,0.053382388,0.403904132,0.144367995,1587142,64339,874977,2526458,0.628208345,0.025466087,0.346325567
Mon 14:30,214969,442889,88160,667040,238421,1651479,0.130167565,0.268177191,0.053382453,0.403904621,0.144368169,1587140,64339,874979,2526458,0.628207554,0.025466087,0.346326359
Mon 15:00,215031,442999,88099,666990,238189,1651308,0.13021859,0.268271576,0.053351041,0.403916168,0.144242625,1587040,64268,875150,2526458,0.628167973,0.025437985,0.346394043
Mon 15:30,215031,442999,88099,666990,238189,1651308,0.13021859,0.268271576,0.053351041,0.403916168,0.144242625,1587040,64268,875150,2526458,0.628167973,0.025437985,0.346394043
Mon 16:00,219968,449506,90964,672584,239994,1673016,0.131479914,0.268680037,0.054371267,0.402018869,0.143449913,1610376,62640,853442,2526458,0.637404619,0.024793604,0.337801776
Mon 16:30,219966,449514,90964,672585,239994,1673023,0.131478169,0.268683694,0.05437104,0.402017785,0.143449313,1610383,62640,853435,2526458,0.63740739,0.024793604,0.337799006
Mon 17:00,220386,450598,91202,673234,240035,1675455,0.131538,0.268940676,0.054434169,0.401821595,0.143265561,1613124,62331,851003,2526458,0.638492308,0.024671299,0.336836393
Mon 17:30,220386,450599,91204,673234,240035,1675458,0.131537765,0.268940791,0.054435265,0.401820875,0.143265304,1613127,62331,851000,2526458,0.638493496,0.024671299,0.336835206
Mon 18:00,221697,455998,103261,678347,240293,1699596,0.130440999,0.268297878,0.060756203,0.399122497,0.141382423,1634146,65450,826862,2526458,0.646813048,0.025905833,0.327281118
Mon 18:30,221697,455998,103261,678347,240293,1699596,0.130440999,0.268297878,0.060756203,0.399122497,0.141382423,1634146,65450,826862,2526458,0.646813048,0.025905833,0.327281118
Mon 19:00,222065,460441,115777,682087,241026,1721396,0.129002856,0.267481161,0.067257621,0.396240609,0.140017753,1712207,9189,805062,2526458,0.677710455,0.003637108,0.318652438
Mon 19:30,222065,460444,115777,682087,241026,1721399,0.129002631,0.267482437,0.067257504,0.396239919,0.140017509,1712210,9189,805059,2526458,0.677711642,0.003637108,0.31865125
Mon 20:00,222074,460532,115926,682222,240961,1721715,0.128984181,0.267484456,0.067331701,0.396245604,0.139954057,1712813,8902,804743,2526458,0.677950316,0.00352351,0.318526174
Mon 20:30,222074,460532,115926,682222,240961,1721715,0.128984181,0.267484456,0.067331701,0.396245604,0.139954057,1712813,8902,804743,2526458,0.677950316,0.00352351,0.318526174
Mon 21:00,222099,460496,115941,681397,240961,1720894,0.129060244,0.267591147,0.06737254,0.395955242,0.140020826,1712078,8816,805564,2526458,0.677659395,0.00348947,0.318851135
Mon 21:30,222099,460496,115941,681397,240961,1720894,0.129060244,0.267591147,0.06737254,0.395955242,0.140020826,1712078,8816,805564,2526458,0.677659395,0.00348947,0.318851135
Mon 22:00,221970,460410,116090,680747,240816,1720033,0.12904985,0.267675097,0.067492891,0.395775546,0.140006616,1715487,4546,806425,2526458,0.679008715,0.001799357,0.319191928
Mon 22:30,221970,460410,116090,680747,240816,1720033,0.12904985,0.267675097,0.067492891,0.395775546,0.140006616,1715487,4546,806425,2526458,0.679008715,0.001799357,0.319191928
Mon 23:00,221977,460435,115414,680698,240717,1719241,0.12911337,0.267812948,0.067130786,0.395929367,0.140013529,1715211,4030,807217,2526458,0.678899471,0.001595119,0.31950541
Mon 23:30,221977,460435,115414,680698,240717,1719241,0.12911337,0.267812948,0.067130786,0.395929367,0.140013529,1715211,4030,807217,2526458,0.678899471,0.001595119,0.31950541
Tue 00:00,220281,451359,115304,679745,240726,1707415,0.129014329,0.264352252,0.067531327,0.398113522,0.14098857,1707415,0,819043,2526458,0.675813728,0,0.324186272
Tue 00:30,220281,451359,115304,679745,240726,1707415,0.129014329,0.264352252,0.067531327,0.398113522,0.14098857,1707415,0,819043,2526458,0.675813728,0,0.324186272
Tue 01:00,220281,451348,115105,679745,240726,1707205,0.129030198,0.264378326,0.067423069,0.398162494,0.141005913,1707205,0,819253,2526458,0.675730608,0,0.324269392
Tue 01:30,220281,451348,115105,679745,240726,1707205,0.129030198,0.264378326,0.067423069,0.398162494,0.141005913,1707205,0,819253,2526458,0.675730608,0,0.324269392
Tue 02:00,220281,450961,114782,679655,240726,1706405,0.129090691,0.26427548,0.067265391,0.398296418,0.14107202,1706405,0,820053,2526458,0.675413959,0,0.324586041
Tue 02:30,220281,450961,114782,679655,240726,1706405,0.129090691,0.26427548,0.067265391,0.398296418,0.14107202,1706405,0,820053,2526458,0.675413959,0,0.324586041
Tue 03:00,221136,457577,115040,679722,240726,1714201,0.129002375,0.266933108,0.067109983,0.396524095,0.14043044,1714201,0,812257,2526458,0.678499702,0,0.321500298
Tue 03:30,221136,457577,115040,679722,240726,1714201,0.129002375,0.266933108,0.067109983,0.396524095,0.14043044,1714201,0,812257,2526458,0.678499702,0,0.321500298
Tue 04:00,221120,457632,114995,679715,240726,1714188,0.128994019,0.266967217,0.06708424,0.396523018,0.140431505,1714188,0,812270,2526458,0.678494556,0,0.321505444
Tue 04:30,221120,457632,114883,679715,240726,1714076,0.129002448,0.266984661,0.067023283,0.396548928,0.140440681,1714076,0,812382,2526458,0.678450226,0,0.321549774
Tue 05:00,221253,457948,114856,680272,240721,1715050,0.129006734,0.267017288,0.066969476,0.396648494,0.140358007,1715050,0,811408,2526458,0.678835746,0,0.321164254
Tue 05:30,221253,457946,114728,680272,240721,1714920,0.129016514,0.267036363,0.066899914,0.396678562,0.140368647,1714920,0,811538,2526458,0.67878429,0,0.32121571
Tue 06:00,221877,459768,115083,681062,240651,1718441,0.129115285,0.267549482,0.066969422,0.396325507,0.140040304,1718441,0,808017,2526458,0.680177941,0,0.319822059
Tue 06:30,221877,459581,115145,680979,240665,1718247,0.129129863,0.267470858,0.067013066,0.396321949,0.140064263,1718247,0,808211,2526458,0.680101153,0,0.319898847
Tue 07:00,215674,443447,96095,667373,238014,1660603,0.129876918,0.267039744,0.057867534,0.401885941,0.143329863,1660012,591,865855,2526458,0.657051097,0.000233924,0.342714979
Tue 07:30,212935,438972,94182,664155,238022,1648266,0.129187279,0.266323518,0.057140049,0.402941637,0.144407517,1646768,1498,878192,2526458,0.651808975,0.000592925,0.3475981
Tue 08:00,207782,420397,82743,659057,237757,1607736,0.12923888,0.261483851,0.051465539,0.40992862,0.14788311,1589816,17920,918722,2526458,0.629266744,0.007092934,0.363640322
Tue 08:30,202022,407080,80838,649852,237757,1577549,0.128060681,0.258045867,0.051242782,0.411937759,0.15071291,1546649,30900,948909,2526458,0.612180768,0.012230562,0.37558867
Tue 09:00,200637,397934,78356,652729,238438,1568094,0.1279496,0.253769226,0.049968943,0.416256296,0.152055935,1507750,60344,958364,2526458,0.596784114,0.023884822,0.379331063
Tue 09:30,195734,395387,76541,644393,238438,1550493,0.126239848,0.255007278,0.049365589,0.41560523,0.153782055,1489391,61102,975965,2526458,0.589517419,0.024184847,0.386297734
Tue 10:00,202746,414003,79951,655079,238453,1590232,0.127494605,0.260341258,0.050276312,0.411939264,0.149948561,1526310,63922,936226,2526458,0.604130367,0.025301034,0.370568598
Tue 10:30,205900,426422,84479,655457,238453,1610711,0.127831746,0.264741471,0.052448267,0.40693644,0.148042076,1546781,63930,915747,2526458,0.612233016,0.025304201,0.362462784
Tue 11:00,213536,426096,82578,660303,238508,1621021,0.131729324,0.262856558,0.050941968,0.407337721,0.147134429,1557037,63984,905437,2526458,0.616292454,0.025325574,0.358381972
Tue 11:30,199261,405058,79306,651119,238508,1573252,0.126655488,0.257465428,0.050408962,0.413868217,0.151601905,1509268,63984,953206,2526458,0.597384956,0.025325574,0.37728947
Tue 12:00,199278,400953,79345,652489,238508,1570573,0.126882354,0.255290903,0.050519778,0.415446464,0.151860499,1506449,64124,955885,2526458,0.596269164,0.025380988,0.378349848
Tue 12:30,200650,416267,84361,656344,238508,1596130,0.125710312,0.260797679,0.052853464,0.411209613,0.149428931,1532006,64124,930328,2526458,0.606384907,0.025380988,0.368234105
Tue 13:00,214956,437401,88269,666153,238508,1645287,0.130649546,0.265850882,0.053649606,0.404885591,0.144964374,1580904,64383,881171,2526458,0.625739276,0.025483503,0.348777221
Tue 13:30,214956,441668,88269,666969,238435,1650297,0.130252918,0.267629402,0.053486736,0.404150889,0.144480054,1585914,64383,876161,2526458,0.627722289,0.025483503,0.346794208
Tue 14:00,214958,442854,88156,666953,238421,1651342,0.130171703,0.268178245,0.053384459,0.403885446,0.144380147,1587003,64339,875116,2526458,0.628153328,0.025466087,0.346380585
Tue 14:30,214958,442852,88156,666953,238421,1651340,0.13017186,0.268177359,0.053384524,0.403885935,0.144380321,1587001,64339,875118,2526458,0.628152536,0.025466087,0.346381377
Tue 15:00,215020,442964,88095,666919,238189,1651187,0.130221471,0.268270038,0.053352528,0.403902768,0.144253195,1586919,64268,875271,2526458,0.62812008,0.025437985,0.346441936
Tue 15:30,215020,442964,88095,666919,238189,1651187,0.130221471,0.268270038,0.053352528,0.403902768,0.144253195,1586919,64268,875271,2526458,0.62812008,0.025437985,0.346441936
Tue 16:00,219961,449473,90960,672513,239994,1672901,0.131484768,0.26867878,0.054372614,0.402004064,0.143459774,1610261,62640,853557,2526458,0.637359101,0.024793604,0.337847295
Tue 16:30,219959,449481,90960,672514,239994,1672908,0.131483022,0.268682438,0.054372386,0.402002979,0.143459174,1610268,62640,853550,2526458,0.637361872,0.024793604,0.337844524
Tue 17:00,220379,450565,91198,673163,240035,1675340,0.131542851,0.268939439,0.054435518,0.401806797,0.143275395,1613009,62331,851118,2526458,0.63844679,0.024671299,0.336881911
Tue 17:30,220379,450566,91200,673163,240035,1675343,0.131542615,0.268939554,0.054436614,0.401806078,0.143275138,1613012,62331,851115,2526458,0.638447977,0.024671299,0.336880724
Tue 18:00,221690,455987,103261,678309,240293,1699540,0.130441178,0.268300246,0.060758205,0.399113289,0.141387081,1634090,65450,826918,2526458,0.646790883,0.025905833,0.327303284
Tue 18:30,221690,455987,103261,678309,240293,1699540,0.130441178,0.268300246,0.060758205,0.399113289,0.141387081,1634090,65450,826918,2526458,0.646790883,0.025905833,0.327303284
Tue 19:00,222058,460449,115776,682094,241026,1721403,0.128998265,0.26748472,0.067256767,0.396243065,0.140017184,1712214,9189,805055,2526458,0.677713225,0.003637108,0.318649667
Tue 19:30,222058,460452,115776,682094,241026,1721406,0.12899804,0.267485997,0.06725665,0.396242374,0.14001694,1712217,9189,805052,2526458,0.677714413,0.003637108,0.318648479
Tue 20:00,222067,460540,115925,682229,240961,1721722,0.128979591,0.267488015,0.067330847,0.396248059,0.139953488,1712820,8902,804736,2526458,0.677953087,0.00352351,0.318523403
Tue 20:30,222067,460540,115925,682229,240961,1721722,0.128979591,0.267488015,0.067330847,0.396248059,0.139953488,1712820,8902,804736,2526458,0.677953087,0.00352351,0.318523403
Tue 21:00,222092,460504,115940,681404,240961,1720901,0.129055652,0.267594708,0.067371685,0.395957699,0.140020257,1712085,8816,805557,2526458,0.677662166,0.00348947,0.318848364
Tue 21:30,222092,460504,115940,681404,240961,1720901,0.129055652,0.267594708,0.067371685,0.395957699,0.140020257,1712085,8816,805557,2526458,0.677662166,0.00348947,0.318848364
Tue 22:00,221970,460424,116085,680754,240816,1720049,0.129048649,0.267680746,0.067489356,0.395775934,0.140005314,1715503,4546,806409,2526458,0.679015048,0.001799357,0.319185595
Tue 22:30,221970,460424,116085,680754,240816,1720049,0.129048649,0.267680746,0.067489356,0.395775934,0.140005314,1715503,4546,806409,2526458,0.679015048,0.001799357,0.319185595
Tue 23:00,221977,460449,115409,680705,240717,1719257,0.129112169,0.267818598,0.067127253,0.395929753,0.140012226,1715227,4030,807201,2526458,0.678905804,0.001595119,0.319499077
Tue 23:30,221977,460449,115409,680705,240717,1719257,0.129112169,0.267818598,0.067127253,0.395929753,0.140012226,1715227,4030,807201,2526458,0.678905804,0.001595119,0.319499077
Wed 00:00,221791,459115,115396,680357,240726,1717385,0.129144601,0.267333766,0.067192854,0.396158695,0.140170084,1717385,0,809073,2526458,0.679759964,0,0.320240036
Wed 00:30,221791,459115,115396,680357,240726,1717385,0.129144601,0.267333766,0.067192854,0.396158695,0.140170084,1717385,0,809073,2526458,0.679759964,0,0.320240036
Wed 01:00,221791,459101,115197,680357,240726,1717172,0.12916062,0.267358774,0.067085301,0.396207835,0.140187471,1717172,0,809286,2526458,0.679675657,0,0.320324343
Wed 01:30,221791,459101,115197,680357,240726,1717172,0.12916062,0.267358774,0.067085301,0.396207835,0.140187471,1717172,0,809286,2526458,0.679675657,0,0.320324343
Wed 02:00,221791,459083,114950,680357,240726,1716907,0.129180555,0.267389556,0.066951792,0.396268988,0.140209109,1716907,0,809551,2526458,0.679570767,0,0.320429233
Wed 02:30,221791,459083,114950,680357,240726,1716907,0.129180555,0.267389556,0.066951792,0.396268988,0.140209109,1716907,0,809551,2526458,0.679570767,0,0.320429233
Wed 03:00,221919,459813,114971,680136,240726,1717565,0.12920559,0.267712139,0.066938369,0.395988507,0.140155394,1717565,0,808893,2526458,0.67983121,0,0.32016879
Wed 03:30,221919,459813,114971,680136,240726,1717565,0.12920559,0.267712139,0.066938369,0.395988507,0.140155394,1717565,0,808893,2526458,0.67983121,0,0.32016879
Wed 04:00,221903,459868,114930,680129,240726,1717556,0.129196952,0.267745564,0.066914849,0.395986506,0.140156129,1717556,0,808902,2526458,0.679827648,0,0.320172352
Wed 04:30,221903,459868,114855,680129,240726,1717481,0.129202594,0.267757256,0.066874102,0.396003799,0.140162249,1717481,0,808977,2526458,0.679797962,0,0.320202038
Wed 05:00,222085,459810,114829,680597,240721,1718042,0.129266339,0.267636065,0.066837132,0.396146893,0.140113571,1718042,0,808416,2526458,0.680020012,0,0.319979988
Wed 05:30,222085,459808,114829,680597,240721,1718040,0.12926649,0.267635212,0.06683721,0.396147354,0.140113734,1718040,0,808418,2526458,0.680019221,0,0.319980779
Wed 06:00,221891,459725,115165,681067,240651,1718499,0.129119074,0.267515431,0.067014878,0.39631504,0.140035578,1718499,0,807959,2526458,0.680200898,0,0.319799102
Wed 06:30,221891,459538,115116,680979,240665,1718189,0.12914237,0.267454861,0.06699845,0.396335327,0.140068991,1718189,0,808269,2526458,0.680078196,0,0.319921804
Wed 07:00,215688,443555,96062,667421,238014,1660740,0.129874634,0.267082746,0.057842889,0.401881691,0.143318039,1660149,591,865718,2526458,0.657105323,0.000233924,0.342660753
Wed 07:30,213436,439763,94423,664902,238022,1650546,0.129312361,0.266434865,0.05720713,0.402837606,0.144208038,1649048,1498,875912,2526458,0.652711424,0.000592925,0.346695651
Wed 08:00,212325,434603,84057,659649,237812,1628446,0.130385042,0.266882046,0.051617923,0.40507883,0.14603616,1610526,17920,898012,2526458,0.637463991,0.007092934,0.355443075
Wed 08:30,212276,429115,84265,653966,237812,1617434,0.131242449,0.265306034,0.052097953,0.404323144,0.14703042,1586534,30900,909024,2526458,0.627967692,0.012230562,0.359801746
Wed 09:00,213199,431384,86029,657322,238493,1626427,0.131084272,0.265234161,0.052894474,0.404150939,0.146636154,1566083,60344,900031,2526458,0.61987296,0.023884822,0.356242217
Wed 09:30,211741,424732,85336,652482,238493,1612784,0.131289125,0.263353307,0.052912231,0.404568746,0.147876591,1551682,61102,913674,2526458,0.614172886,0.024184847,0.361642268
Wed 10:00,212865,435261,87048,660526,238508,1634208,0.130255757,0.266343697,0.053266169,0.404187227,0.14594715,1570286,63922,892250,2526458,0.621536554,0.025301034,0.353162412
Wed 10:30,213215,435607,87053,661327,238508,1635710,0.130350123,0.266310654,0.053220314,0.404305775,0.145813133,1571780,63930,890748,2526458,0.622127896,0.025304201,0.352567903
Wed 11:00,214901,440063,87996,663471,238508,1644939,0.13064375,0.267525422,0.053494993,0.403340793,0.144995042,1580955,63984,881519,2526458,0.625759462,0.025325574,0.348914963
Wed 11:30,211748,431314,86979,657977,238508,1626526,0.130184209,0.26517498,0.053475321,0.404529039,0.146636451,1562542,63984,899932,2526458,0.618471394,0.025325574,0.356203032
Wed 12:00,211756,431454,87018,658596,238508,1627332,0.130124646,0.265129672,0.053472801,0.404709058,0.146563823,1563208,64124,899126,2526458,0.618735004,0.025380988,0.355884008
Wed 12:30,211756,433809,87018,661509,238508,1632600,0.129704765,0.265716648,0.053300257,0.405187431,0.146090898,1568476,64124,893858,2526458,0.620820136,0.025380988,0.353798876
Wed 13:00,214936,442757,88277,667012,238508,1651490,0.130146716,0.268095477,0.053452942,0.403884977,0.144419887,1587107,64383,874968,2526458,0.628194492,0.025483503,0.346322005
Wed 13:30,214936,442757,88277,667012,238435,1651417,0.130152469,0.268107328,0.053455305,0.40390283,0.144382067,1587034,64383,875041,2526458,0.628165598,0.025483503,0.346350899
Wed 14:00,214938,442850,88161,666993,238421,1651363,0.130157936,0.268172413,0.053386808,0.403904532,0.144378311,1587024,64339,875095,2526458,0.62816164,0.025466087,0.346372273
Wed 14:30,214938,442848,88161,666993,238421,1651361,0.130158094,0.268171526,0.053386873,0.403905021,0.144378485,1587022,64339,875097,2526458,0.628160848,0.025466087,0.346373065
Wed 15:00,215000,442958,88100,666966,238189,1651213,0.130207308,0.268262181,0.053354716,0.403924872,0.144250923,1586945,64268,875245,2526458,0.628130371,0.025437985,0.346431645
Wed 15:30,215000,442958,88100,666966,238189,1651213,0.130207308,0.268262181,0.053354716,0.403924872,0.144250923,1586945,64268,875245,2526458,0.628130371,0.025437985,0.346431645
Wed 16:00,219944,449463,90965,672560,239994,1672926,0.131472641,0.268668788,0.05437479,0.402026151,0.143457631,1610286,62640,853532,2526458,0.637368996,0.024793604,0.337837399
Wed 16:30,219942,449471,90965,672561,239994,1672933,0.131470896,0.268672445,0.054374563,0.402025066,0.14345703,1610293,62640,853525,2526458,0.637371767,0.024793604,0.337834629
Wed 17:00,220386,450565,91203,673210,240035,1675399,0.131542397,0.268929968,0.054436585,0.401820701,0.143270349,1613068,62331,851059,2526458,0.638470143,0.024671299,0.336858559
Wed 17:30,220386,450566,91205,673210,240035,1675402,0.131542161,0.268930084,0.054437681,0.401819981,0.143270093,1613071,62331,851056,2526458,0.63847133,0.024671299,0.336857371
Wed 18:00,221697,455993,103266,678347,240293,1699596,0.130440999,0.268294936,0.060759145,0.399122497,0.141382423,1634146,65450,826862,2526458,0.646813048,0.025905833,0.327281118
Wed 18:30,221697,455997,103266,678347,240293,1699600,0.130440692,0.268296658,0.060759002,0.399121558,0.14138209,1634150,65450,826858,2526458,0.646814631,0.025905833,0.327279535
Wed 19:00,222065,460440,115781,682087,241026,1721399,0.129002631,0.267480114,0.067259828,0.396239919,0.140017509,1712210,9189,805059,2526458,0.677711642,0.003637108,0.31865125
Wed 19:30,222065,460443,115781,682087,241026,1721402,0.129002406,0.26748139,0.06725971,0.396239228,0.140017265,1712213,9189,805056,2526458,0.67771283,0.003637108,0.318650063
Wed 20:00,222074,460533,115930,682222,240961,1721720,0.128983807,0.26748426,0.067333829,0.396244453,0.139953651,1712818,8902,804738,2526458,0.677952295,0.00352351,0.318524195
Wed 20:30,222074,460533,115930,682222,240961,1721720,0.128983807,0.26748426,0.067333829,0.396244453,0.139953651,1712818,8902,804738,2526458,0.677952295,0.00352351,0.318524195
Wed 21:00,222099,460497,115945,681397,240961,1720899,0.129059869,0.267590951,0.067374669,0.395954091,0.14002042,1712083,8816,805559,2526458,0.677661374,0.00348947,0.318849156
Wed 21:30,222099,460497,115945,681397,240961,1720899,0.129059869,0.267590951,0.067374669,0.395954091,0.14002042,1712083,8816,805559,2526458,0.677661374,0.00348947,0.318849156
Wed 22:00,221970,460415,116090,680747,240816,1720038,0.129049474,0.267677226,0.067492695,0.395774396,0.140006209,1715492,4546,806420,2526458,0.679010694,0.001799357,0.319189949
Wed 22:30,221970,460415,116090,680747,240816,1720038,0.129049474,0.267677226,0.067492695,0.395774396,0.140006209,1715492,4546,806420,2526458,0.679010694,0.001799357,0.319189949
Wed 23:00,221977,460440,115414,680698,240717,1719246,0.129112995,0.267815077,0.067130591,0.395928215,0.140013122,1715216,4030,807212,2526458,0.67890145,0.001595119,0.319503431
Wed 23:30,221977,460440,115414,680698,240717,1719246,0.129112995,0.267815077,0.067130591,0.395928215,0.140013122,1715216,4030,807212,2526458,0.67890145,0.001595119,0.319503431
Thu 00:00,220364,451554,115327,679768,240726,1707739,0.129038454,0.264416284,0.067531982,0.398051459,0.140961821,1707739,0,818719,2526458,0.675941971,0,0.324058029
Thu 00:30,220364,451554,115327,679768,240726,1707739,0.129038454,0.264416284,0.067531982,0.398051459,0.140961821,1707739,0,818719,2526458,0.675941971,0,0.324058029
Thu 01:00,220364,451544,115102,679768,240726,1707504,0.129056213,0.264446818,0.067409505,0.398106242,0.140981222,1707504,0,818954,2526458,0.675848955,0,0.324151045
Thu 01:30,220364,451544,115102,679768,240726,1707504,0.129056213,0.264446818,0.067409505,0.398106242,0.140981222,1707504,0,818954,2526458,0.675848955,0,0.324151045
Thu 02:00,220364,451130,114762,679717,240726,1706699,0.129117085,0.264328977,0.067242085,0.398264134,0.141047718,1706699,0,819759,2526458,0.675530327,0,0.324469673
Thu 02:30,220364,451130,114762,679717,240726,1706699,0.129117085,0.264328977,0.067242085,0.398264134,0.141047718,1706699,0,819759,2526458,0.675530327,0,0.324469673
Thu 03:00,221034,457272,114996,679773,240726,1713801,0.128972967,0.266817443,0.067099973,0.396646402,0.140463216,1713801,0,812657,2526458,0.678341378,0,0.321658622
Thu 03:30,221034,457272,114996,679773,240726,1713801,0.128972967,0.266817443,0.067099973,0.396646402,0.140463216,1713801,0,812657,2526458,0.678341378,0,0.321658622
Thu 04:00,221018,457325,114977,679766,240726,1713812,0.128962803,0.266846655,0.067088455,0.396639771,0.140462314,1713812,0,812646,2526458,0.678345731,0,0.321654269
Thu 04:30,221018,457325,114854,679766,240726,1713689,0.12897206,0.266865808,0.067021496,0.39666824,0.140472396,1713689,0,812769,2526458,0.678297047,0,0.321702953
Thu 05:00,221151,457674,114827,680285,240721,1714658,0.128976741,0.266918534,0.066967873,0.396746756,0.140390095,1714658,0,811800,2526458,0.678680588,0,0.321319412
Thu 05:30,221151,457672,114681,680285,240721,1714510,0.128987874,0.266940409,0.066888499,0.396781004,0.140402214,1714510,0,811948,2526458,0.678622008,0,0.321377992
Thu 06:00,221896,459737,115123,681068,240651,1718475,0.129123787,0.26752615,0.066991373,0.396321157,0.140037533,1718475,0,807983,2526458,0.680191398,0,0.319808602
Thu 06:30,221900,459566,115129,680980,240665,1718240,0.129143775,0.267463218,0.067004027,0.396324146,0.140064834,1718240,0,808218,2526458,0.680098383,0,0.319901617
Thu 07:00,215697,443421,96061,667376,238014,1660569,0.129893428,0.267029554,0.057848244,0.401895977,0.143332797,1659978,591,865889,2526458,0.657037639,0.000233924,0.342728436
Thu 07:30,213124,439170,94240,664446,238022,1649002,0.129244234,0.266324722,0.057149718,0.402938262,0.144343063,1647504,1498,877456,2526458,0.652100292,0.000592925,0.347306783
Thu 08:00,208375,420483,82838,659005,237812,1608513,0.129545114,0.261411005,0.051499739,0.409698274,0.147845868,1590603,17910,917945,2526458,0.629578247,0.007088976,0.363332777
Thu 08:30,202327,404122,80724,650666,237812,1575651,0.128408512,0.256479385,0.051232157,0.412950584,0.150929362,1544761,30890,950807,2526458,0.611433477,0.012226603,0.376339919
Thu 09:00,201190,395748,78789,654221,238493,1568441,0.128273872,0.252319341,0.050233958,0.417115467,0.152057361,1508107,60334,958017,2526458,0.596925419,0.023880864,0.379193717
Thu 09:30,197101,394598,77163,647652,238493,1555007,0.126752484,0.253759629,0.049622285,0.416494588,0.153371014,1493915,61092,971451,2526458,0.591308068,0.024180889,0.384511043
Thu 10:00,204253,415973,80815,657636,238508,1597185,0.127883119,0.260441339,0.050598397,0.411746917,0.149330228,1533273,63912,929273,2526458,0.6068864,0.025297076,0.367816524
Thu 10:30,207142,427722,84810,657709,238508,1615891,0.128190577,0.264697309,0.052484976,0.407025598,0.14760154,1551971,63920,910567,2526458,0.614287275,0.025300242,0.360412483
Thu 11:00,213933,424821,83183,662172,238508,1622617,0.131844422,0.261812245,0.051264716,0.408088908,0.146989709,1558643,63974,903841,2526458,0.616928126,0.025321616,0.357750257
Thu 11:30,202067,403719,80123,653038,238508,1577455,0.12809684,0.255930597,0.050792574,0.413982015,0.151197974,1513481,63974,949003,2526458,0.599052508,0.025321616,0.375625876
Thu 12:00,202075,399816,80162,654462,238508,1575023,0.128299714,0.253847722,0.050895765,0.415525361,0.151431439,1510909,64114,951435,2526458,0.598034481,0.02537703,0.376588489
Thu 12:30,203064,416588,84657,656820,238508,1599637,0.1269438,0.260426584,0.052922632,0.410605656,0.149101327,1535523,64114,926821,2526458,0.607776975,0.02537703,0.366845995
Thu 13:00,214960,437791,88235,666455,238508,1645949,0.130599429,0.265980902,0.053607372,0.404906227,0.144906069,1581576,64373,880509,2526458,0.626005261,0.025479545,0.348515194
Thu 13:30,214960,441835,88235,666958,238435,1650423,0.130245398,0.267710157,0.053462052,0.40411337,0.144469024,1586050,64373,876035,2526458,0.62777612,0.025479545,0.346744335
Thu 14:00,214962,442905,88122,666983,238421,1651393,0.130170105,0.268200846,0.053362222,0.403891139,0.144375688,1587064,64329,875065,2526458,0.628177472,0.025462129,0.346360399
Thu 14:30,214962,442903,88122,666983,238421,1651391,0.130170263,0.26819996,0.053362287,0.403891628,0.144375863,1587062,64329,875067,2526458,0.628176681,0.025462129,0.34636119
Thu 15:00,215024,443015,88061,666942,238189,1651231,0.130220423,0.268293776,0.053330515,0.403905934,0.144249351,1586973,64258,875227,2526458,0.628141453,0.025434027,0.34642452
Thu 15:30,215024,443015,88061,666942,238189,1651231,0.130220423,0.268293776,0.053330515,0.403905934,0.144249351,1586973,64258,875227,2526458,0.628141453,0.025434027,0.34642452
Thu 16:00,219961,449518,90947,672536,239994,1672956,0.131480445,0.268696846,0.054363056,0.402004595,0.143455058,1610326,62630,853502,2526458,0.637384829,0.024789646,0.337825525
Thu 16:30,219959,449526,90947,672537,239994,1672963,0.1314787,0.268700503,0.054362828,0.402003511,0.143454458,1610333,62630,853495,2526458,0.6373876,0.024789646,0.337822754
Thu 17:00,220379,450620,91185,673186,240035,1675405,0.131537748,0.268961833,0.054425646,0.401804937,0.143269836,1613084,62321,851053,2526458,0.638476476,0.024667341,0.336856184
Thu 17:30,220379,450621,91187,673186,240035,1675408,0.131537512,0.268961948,0.054426743,0.401804217,0.14326958,1613087,62321,851050,2526458,0.638477663,0.024667341,0.336854996
Thu 18:00,221690,455985,103251,678309,240293,1699528,0.130442099,0.268300964,0.06075275,0.399116108,0.14138808,1634088,65440,826930,2526458,0.646790091,0.025901875,0.327308034
Thu 18:30,221690,455985,103251,678309,240293,1699528,0.130442099,0.268300964,0.06075275,0.399116108,0.14138808,1634088,65440,826930,2526458,0.646790091,0.025901875,0.327308034
Thu 19:00,222058,460449,115777,682094,241026,1721404,0.12899819,0.267484565,0.067257309,0.396242834,0.140017102,1712225,9179,805054,2526458,0.677717579,0.00363315,0.318649271
Thu 19:30,222058,460452,115777,682094,241026,1721407,0.128997965,0.267485842,0.067257191,0.396242144,0.140016858,1712228,9179,805051,2526458,0.677718767,0.00363315,0.318648084
Thu 20:00,222067,460540,115926,682229,240961,1721723,0.128979516,0.26748786,0.067331388,0.396247828,0.139953407,1712831,8892,804735,2526458,0.677957441,0.003519552,0.318523007
Thu 20:30,222067,460540,115926,682229,240961,1721723,0.128979516,0.26748786,0.067331388,0.396247828,0.139953407,1712831,8892,804735,2526458,0.677957441,0.003519552,0.318523007
Thu 21:00,222092,460504,115941,681404,240961,1720902,0.129055577,0.267594552,0.067372227,0.395957469,0.140020175,1712096,8806,805556,2526458,0.67766652,0.003485512,0.318847968
Thu 21:30,222092,460504,115941,681404,240961,1720902,0.129055577,0.267594552,0.067372227,0.395957469,0.140020175,1712096,8806,805556,2526458,0.67766652,0.003485512,0.318847968
Thu 22:00,221970,460416,116090,680754,240816,1720046,0.129048874,0.267676562,0.067492381,0.395776625,0.140005558,1715500,4546,806412,2526458,0.679013861,0.001799357,0.319186782
Thu 22:30,221970,460418,116090,680754,240816,1720048,0.129048724,0.267677414,0.067492303,0.395776164,0.140005395,1715502,4546,806410,2526458,0.679014652,0.001799357,0.319185991
Thu 23:00,221977,460443,115413,680705,240717,1719255,0.129112319,0.26781542,0.067129658,0.395930214,0.140012389,1715225,4030,807203,2526458,0.678905012,0.001595119,0.319499869
Thu 23:30,221977,460443,115413,680705,240717,1719255,0.129112319,0.26781542,0.067129658,0.395930214,0.140012389,1715225,4030,807203,2526458,0.678905012,0.001595119,0.319499869
Fri 00:00,220409,451205,115293,678468,240726,1706101,0.129188717,0.264465586,0.06757689,0.39767165,0.141097157,1706101,0,820357,2526458,0.675293632,0,0.324706368
Fri 00:30,220409,451205,115293,678468,240726,1706101,0.129188717,0.264465586,0.06757689,0.39767165,0.141097157,1706101,0,820357,2526458,0.675293632,0,0.324706368
Fri 01:00,220409,451194,115094,678468,240726,1705891,0.129204621,0.264491694,0.067468555,0.397720605,0.141114526,1705891,0,820567,2526458,0.675210512,0,0.324789488
Fri 01:30,220409,451194,115094,678468,240726,1705891,0.129204621,0.264491694,0.067468555,0.397720605,0.141114526,1705891,0,820567,2526458,0.675210512,0,0.324789488
Fri 02:00,220409,450807,114752,678378,240726,1705072,0.129266682,0.264391768,0.067300384,0.397858859,0.141182308,1705072,0,821386,2526458,0.674886343,0,0.325113657
Fri 02:30,220409,450807,114752,678378,240726,1705072,0.129266682,0.264391768,0.067300384,0.397858859,0.141182308,1705072,0,821386,2526458,0.674886343,0,0.325113657
Fri 03:00,221150,457515,114734,679377,240726,1713502,0.12906317,0.267005816,0.066958778,0.39648451,0.140487726,1713502,0,812956,2526458,0.67822303,0,0.32177697
Fri 03:30,221150,457515,114734,679377,240726,1713502,0.12906317,0.267005816,0.066958778,0.39648451,0.140487726,1713502,0,812956,2526458,0.67822303,0,0.32177697
Fri 04:00,221134,457570,114693,679370,240726,1713493,0.12905451,0.267039317,0.066935202,0.396482507,0.140488464,1713493,0,812965,2526458,0.678219468,0,0.321780532
Fri 04:30,221134,457570,114603,679370,240726,1713403,0.129061289,0.267053344,0.066886191,0.396503333,0.140495844,1713403,0,813055,2526458,0.678183845,0,0.321816155
Fri 05:00,221267,457886,114572,679927,240721,1714373,0.129065845,0.267086568,0.066830264,0.39660389,0.140413434,1714373,0,812085,2526458,0.678567781,0,0.321432219
Fri 05:30,221267,457884,114444,679927,240721,1714243,0.129075633,0.267105655,0.066760663,0.396633966,0.140424082,1714243,0,812215,2526458,0.678516326,0,0.321483674
Fri 06:00,221892,459732,115072,681064,240651,1718411,0.129126268,0.267533204,0.06696419,0.39633359,0.140042749,1718411,0,808047,2526458,0.680166066,0,0.319833934
Fri 06:30,221892,459545,115134,680981,240665,1718217,0.129140848,0.267454576,0.067007834,0.396330033,0.140066709,1718217,0,808241,2526458,0.680089279,0,0.319910721
Fri 07:00,215689,443459,96088,667423,238014,1660673,0.129880476,0.267035714,0.057860879,0.40189911,0.143323821,1660082,591,865785,2526458,0.657078804,0.000233924,0.342687272
Fri 07:30,212710,438892,94139,664241,238022,1648004,0.129071289,0.266317315,0.057123041,0.403057881,0.144430475,1646506,1498,878454,2526458,0.651705273,0.000592925,0.347701802
Fri 08:00,207776,420618,82715,658949,237757,1607815,0.129228798,0.261608456,0.051445595,0.409841306,0.147875844,1589895,17920,918643,2526458,0.629298013,0.007092934,0.363609053
Fri 08:30,201677,405781,80596,649650,237757,1575461,0.12801142,0.257563342,0.05115709,0.412355495,0.150912654,1544561,30900,950997,2526458,0.611354315,0.012230562,0.376415123
Fri 09:00,200287,396976,78233,653095,238438,1567029,0.127813206,0.253330347,0.049924411,0.416772759,0.152159277,1506685,60344,959429,2526458,0.596362576,0.023884822,0.379752602
Fri 09:30,195490,396379,76473,645541,238438,1552321,0.125934005,0.255346027,0.049263651,0.415855355,0.153600963,1491219,61102,974137,2526458,0.590240962,0.024184847,0.385574191
Fri 10:00,202894,416388,79973,656545,238453,1594253,0.127265873,0.261180628,0.050163305,0.41181983,0.149570363,1530331,63922,932205,2526458,0.605721924,0.025301034,0.368977042
Fri 10:30,206032,428544,84501,657372,238453,1614902,0.127581736,0.265368425,0.052325776,0.407066187,0.147657876,1550972,63930,911556,2526458,0.61389186,0.025304201,0.36080394
Fri 11:00,213557,425367,82566,662718,238508,1622716,0.131604668,0.262132745,0.050881362,0.408400484,0.146980741,1558732,63984,903742,2526458,0.616963353,0.025325574,0.357711072
Fri 11:30,199764,404105,79122,653581,238508,1575080,0.126827844,0.256561571,0.050233639,0.414950987,0.151425959,1511096,63984,951378,2526458,0.598108498,0.025325574,0.376565927
Fri 12:00,199772,399979,79161,654275,238508,1571695,0.127106086,0.254488943,0.050366642,0.416286239,0.151752089,1507571,64124,954763,2526458,0.596713264,0.025380988,0.377905748
Fri 12:30,201144,416073,84180,656740,238508,1596645,0.125979163,0.260592054,0.052723054,0.411324997,0.149380733,1532521,64124,929813,2526458,0.60658875,0.025380988,0.368030262
Fri 13:00,214964,437436,88260,666414,238508,1645582,0.130630986,0.265824492,0.05363452,0.404971615,0.144938387,1581199,64383,880876,2526458,0.62585604,0.025483503,0.348660457
Fri 13:30,214964,441699,88260,666976,238435,1650334,0.130254845,0.267642186,0.053480083,0.40414607,0.144476815,1585951,64383,876124,2526458,0.627736934,0.025483503,0.346779563
Fri 14:00,214966,442885,88144,667003,238421,1651419,0.130170478,0.268184513,0.053374704,0.403896891,0.144373415,1587080,64339,875039,2526458,0.628183805,0.025466087,0.346350108
Fri 14:30,214966,442883,88144,667003,238421,1651417,0.130170635,0.268183627,0.053374768,0.40389738,0.144373589,1587078,64339,875041,2526458,0.628183014,0.025466087,0.346350899
Fri 15:00,215028,442999,88095,666960,238189,1651271,0.130219691,0.268277587,0.053349814,0.403907051,0.144245857,1587003,64268,875187,2526458,0.628153328,0.025437985,0.346408688
Fri 15:30,215028,442999,88095,666960,238189,1651271,0.130219691,0.268277587,0.053349814,0.403907051,0.144245857,1587003,64268,875187,2526458,0.628153328,0.025437985,0.346408688
Fri 16:00,219965,449508,90960,672554,239994,1672981,0.131480872,0.268686853,0.054370014,0.402009347,0.143452914,1610341,62640,853477,2526458,0.637390766,0.024793604,0.33781563
Fri 16:30,219963,449516,90960,672555,239994,1672988,0.131479126,0.268690511,0.054369786,0.402008263,0.143452314,1610348,62640,853470,2526458,0.637393537,0.024793604,0.337812859
Fri 17:00,220387,450593,91198,673204,240035,1675417,0.13154158,0.268943791,0.054433016,0.401812802,0.14326881,1613206,62211,851041,2526458,0.638524765,0.024623801,0.336851434
Fri 17:30,220387,450594,91200,673204,240035,1675420,0.131541345,0.268943907,0.054434112,0.401812083,0.143268554,1613209,62211,851038,2526458,0.638525952,0.024623801,0.336850246
Fri 18:00,221697,455999,103261,678347,240293,1699597,0.130440922,0.268298308,0.060756167,0.399122263,0.141382339,1634267,65330,826861,2526458,0.646860941,0.025858336,0.327280723
Fri 18:30,221697,455999,103261,678347,240293,1699597,0.130440922,0.268298308,0.060756167,0.399122263,0.141382339,1634267,65330,826861,2526458,0.646860941,0.025858336,0.327280723
Fri 19:00,222065,460448,115776,682087,241026,1721402,0.129002406,0.267484295,0.067256806,0.396239228,0.140017265,1712217,9185,805056,2526458,0.677714413,0.003635525,0.318650063
Fri 19:30,222065,460451,115776,682087,241026,1721405,0.129002181,0.267485571,0.067256689,0.396238538,0.140017021,1712220,9185,805053,2526458,0.6777156,0.003635525,0.318648875
Fri 20:00,222074,460539,115925,682222,240961,1721721,0.128983732,0.267487589,0.067330886,0.396244223,0.13995357,1712823,8898,804737,2526458,0.677954274,0.003521927,0.318523799
Fri 20:30,222074,460539,115925,682222,240961,1721721,0.128983732,0.267487589,0.067330886,0.396244223,0.13995357,1712823,8898,804737,2526458,0.677954274,0.003521927,0.318523799
Fri 21:00,222099,460503,115940,681397,240961,1720900,0.129059794,0.267594282,0.067371724,0.395953861,0.140020338,1712088,8812,805558,2526458,0.677663353,0.003487887,0.31884876
Fri 21:30,222099,460503,115940,681397,240961,1720900,0.129059794,0.267594282,0.067371724,0.395953861,0.140020338,1712088,8812,805558,2526458,0.677663353,0.003487887,0.31884876
Fri 22:00,221970,460421,116085,680747,240816,1720039,0.129049399,0.267680558,0.067489749,0.395774166,0.140006128,1715497,4542,806419,2526458,0.679012673,0.001797774,0.319189553
Fri 22:30,221970,460421,116085,680747,240816,1720039,0.129049399,0.267680558,0.067489749,0.395774166,0.140006128,1715497,4542,806419,2526458,0.679012673,0.001797774,0.319189553
Fri 23:00,221977,460446,115400,680698,240717,1719238,0.129113596,0.267819813,0.06712276,0.395930057,0.140013774,1715208,4030,807220,2526458,0.678898284,0.001595119,0.319506598
Fri 23:30,221977,460446,115400,680698,240717,1719238,0.129113596,0.267819813,0.06712276,0.395930057,0.140013774,1715208,4030,807220,2526458,0.678898284,0.001595119,0.319506598
Sat 00:00,221709,457552,115247,677714,240726,1712948,0.12943125,0.267113771,0.067279917,0.395641899,0.140533163,1712948,0,813510,2526458,0.678003751,0,0.321996249
Sat 00:30,221709,457552,115247,677714,240726,1712948,0.12943125,0.267113771,0.067279917,0.395641899,0.140533163,1712948,0,813510,2526458,0.678003751,0,0.321996249
Sat 01:00,221709,457538,114982,677714,240726,1712669,0.129452334,0.267149111,0.067136148,0.395706351,0.140556056,1712669,0,813789,2526458,0.677893319,0,0.322106681
Sat 01:30,221709,457538,114982,677714,240726,1712669,0.129452334,0.267149111,0.067136148,0.395706351,0.140556056,1712669,0,813789,2526458,0.677893319,0,0.322106681
Sat 02:00,221709,457523,114797,677714,240726,1712469,0.129467453,0.267171552,0.067035958,0.395752565,0.140572472,1712469,0,813989,2526458,0.677814157,0,0.322185843
Sat 02:30,221709,457523,114797,677714,240726,1712469,0.129467453,0.267171552,0.067035958,0.395752565,0.140572472,1712469,0,813989,2526458,0.677814157,0,0.322185843
Sat 03:00,221804,457971,115034,677385,240726,1712920,0.129488826,0.267362749,0.067156668,0.395456297,0.14053546,1712920,0,813538,2526458,0.677992668,0,0.322007332
Sat 03:30,221804,457971,115034,677385,240726,1712920,0.129488826,0.267362749,0.067156668,0.395456297,0.14053546,1712920,0,813538,2526458,0.677992668,0,0.322007332
Sat 04:00,221964,458026,114989,677385,240726,1713090,0.129569375,0.267368323,0.067123735,0.395417053,0.140521514,1713090,0,813368,2526458,0.678059956,0,0.321940044
Sat 04:30,221964,458026,114900,677385,240726,1713001,0.129576106,0.267382214,0.067075267,0.395437598,0.140528815,1713001,0,813457,2526458,0.678024729,0,0.321975271
Sat 05:00,222109,458028,114885,677966,240721,1713709,0.129607185,0.267272915,0.067038803,0.395613258,0.140467839,1713709,0,812749,2526458,0.678304963,0,0.321695037
Sat 05:30,222109,458028,114885,677966,240721,1713709,0.129607185,0.267272915,0.067038803,0.395613258,0.140467839,1713709,0,812749,2526458,0.678304963,0,0.321695037
Sat 06:00,222040,458371,116095,678995,240936,1716437,0.129360996,0.26704796,0.067637204,0.395583992,0.140369848,1716437,0,810021,2526458,0.679384735,0,0.320615265
Sat 06:30,222040,458184,116046,678907,240950,1716127,0.129384364,0.266987233,0.06762087,0.395604171,0.140403362,1716127,0,810331,2526458,0.679262034,0,0.320737966
Sat 07:00,216726,447574,106102,669880,238701,1678983,0.129081712,0.266574468,0.063194207,0.39897962,0.142169992,1678170,813,847475,2526458,0.664238234,0.000321794,0.335439972
Sat 07:30,214529,443835,104673,667402,238709,1669148,0.12852605,0.26590512,0.062710437,0.399845909,0.143012483,1667382,1766,857310,2526458,0.659968224,0.000699002,0.339332773
Sat 08:00,214436,442680,102891,666343,238872,1665222,0.128773221,0.265838429,0.061788158,0.400152652,0.14344754,1643440,21782,861236,2526458,0.650491716,0.008621556,0.340886728
Sat 08:30,215359,444998,103466,666997,238872,1669692,0.128981273,0.266515022,0.061967117,0.399473076,0.143063511,1634968,34724,856766,2526458,0.647138405,0.013744143,0.339117452
Sat 09:00,216483,447619,105293,670312,239008,1678715,0.128957566,0.266643832,0.06272238,0.399300656,0.142375567,1613133,65582,847743,2526458,0.638495871,0.02595808,0.335546049
Sat 09:30,216648,447751,105470,670051,239008,1678928,0.129039482,0.266688625,0.062819847,0.399094541,0.142357504,1612588,66340,847530,2526458,0.638280153,0.026258105,0.335461741
Sat 10:00,216710,447854,105882,670340,239020,1679806,0.129008945,0.266610549,0.063032279,0.399057986,0.142290241,1612369,67437,846652,2526458,0.638193471,0.02669231,0.335114219
Sat 10:30,216778,447882,105887,670331,239020,1679898,0.129042359,0.266612616,0.063031803,0.399030774,0.142282448,1612453,67445,846560,2526458,0.638226719,0.026695476,0.335077805
Sat 11:00,216815,447888,105887,670821,239020,1680431,0.129023447,0.266531622,0.063011811,0.399195802,0.142237319,1612981,67450,846027,2526458,0.638435707,0.026697455,0.334866837
Sat 11:30,216815,447888,105887,670821,239020,1680431,0.129023447,0.266531622,0.063011811,0.399195802,0.142237319,1612981,67450,846027,2526458,0.638435707,0.026697455,0.334866837
Sat 12:00,216815,447910,105901,670828,239020,1680474,0.129020146,0.266537893,0.063018529,0.399189752,0.142233679,1613017,67457,845984,2526458,0.638449956,0.026700226,0.334849817
Sat 12:30,216815,447910,105901,670828,239020,1680474,0.129020146,0.266537893,0.063018529,0.399189752,0.142233679,1613017,67457,845984,2526458,0.638449956,0.026700226,0.334849817
Sat 13:00,216822,447934,105884,670827,239020,1680487,0.129023313,0.266550113,0.063007926,0.399186069,0.142232579,1612885,67602,845971,2526458,0.638397709,0.026757619,0.334844672
Sat 13:30,216822,447934,105884,670827,239020,1680487,0.129023313,0.266550113,0.063007926,0.399186069,0.142232579,1612885,67602,845971,2526458,0.638397709,0.026757619,0.334844672
Sat 14:00,216828,447939,105884,670790,239006,1680447,0.129029955,0.266559433,0.063009425,0.399173553,0.142227633,1612861,67586,846011,2526458,0.63838821,0.026751286,0.334860504
Sat 14:30,216828,447939,105884,670790,239006,1680447,0.129029955,0.266559433,0.063009425,0.399173553,0.142227633,1612861,67586,846011,2526458,0.63838821,0.026751286,0.334860504
Sat 15:00,216844,447963,105858,670830,239025,1680520,0.12903387,0.266562136,0.062991217,0.399180016,0.142232761,1612999,67521,845938,2526458,0.638442832,0.026725558,0.33483161
Sat 15:30,216844,447963,105858,670830,239025,1680520,0.12903387,0.266562136,0.062991217,0.399180016,0.142232761,1612999,67521,845938,2526458,0.638442832,0.026725558,0.33483161
Sat 16:00,221510,455886,108699,678084,241061,1705240,0.129899604,0.267344186,0.063744106,0.397647252,0.141364852,1638394,66846,821218,2526458,0.648494453,0.026458386,0.325047161
Sat 16:30,221510,455886,108699,678084,241061,1705240,0.129899604,0.267344186,0.063744106,0.397647252,0.141364852,1638394,66846,821218,2526458,0.648494453,0.026458386,0.325047161
Sat 17:00,221717,456400,108800,678347,241043,1706307,0.129939688,0.267478244,0.063763438,0.397552726,0.141265903,1639752,66555,820151,2526458,0.649031965,0.026343205,0.32462483
Sat 17:30,221717,456400,108800,678347,241043,1706307,0.129939688,0.267478244,0.063763438,0.397552726,0.141265903,1639752,66555,820151,2526458,0.649031965,0.026343205,0.32462483
Sat 18:00,222178,457863,110691,679234,240986,1710952,0.129856361,0.267607157,0.064695561,0.39699185,0.140849071,1644896,66056,815506,2526458,0.651068017,0.026145695,0.322786288
Sat 18:30,222178,457863,110691,679234,240986,1710952,0.129856361,0.267607157,0.064695561,0.39699185,0.140849071,1644896,66056,815506,2526458,0.651068017,0.026145695,0.322786288
Sat 19:00,222081,458572,116051,679359,241026,1717089,0.129335754,0.267063618,0.067585897,0.39564577,0.140368962,1708067,9022,809369,2526458,0.676071797,0.003571007,0.320357196
Sat 19:30,222081,458572,116046,679359,241026,1717084,0.12933613,0.267064395,0.067583182,0.395646922,0.14036937,1708093,8991,809374,2526458,0.676082088,0.003558737,0.320359175
Sat 20:00,222079,458648,116087,679464,240961,1717239,0.129323292,0.267084547,0.067600957,0.395672355,0.140318849,1708535,8704,809219,2526458,0.676257037,0.003445139,0.320297824
Sat 20:30,222079,458648,116087,679464,240961,1717239,0.129323292,0.267084547,0.067600957,0.395672355,0.140318849,1708535,8704,809219,2526458,0.676257037,0.003445139,0.320297824
Sat 21:00,222096,458611,116095,678639,240961,1716402,0.12939626,0.267193233,0.067638584,0.395384648,0.140387275,1707779,8623,810056,2526458,0.675957803,0.003413079,0.320629118
Sat 21:30,222096,458611,116095,678639,240961,1716402,0.12939626,0.267193233,0.067638584,0.395384648,0.140387275,1707779,8623,810056,2526458,0.675957803,0.003413079,0.320629118
Sat 22:00,221974,458529,116210,677986,240816,1715515,0.129392048,0.267283585,0.067740591,0.395208436,0.140375339,1710935,4580,810943,2526458,0.677206983,0.001812815,0.320980202
Sat 22:30,221974,458529,116210,677986,240816,1715515,0.129392048,0.267283585,0.067740591,0.395208436,0.140375339,1710935,4580,810943,2526458,0.677206983,0.001812815,0.320980202
Sat 23:00,221977,458554,115513,677937,240717,1714698,0.129455449,0.267425517,0.067366382,0.395368164,0.140384488,1710634,4064,811760,2526458,0.677087844,0.001608576,0.32130358
Sat 23:30,221977,458554,115513,677937,240717,1714698,0.129455449,0.267425517,0.067366382,0.395368164,0.140384488,1710634,4064,811760,2526458,0.677087844,0.001608576,0.32130358
Sun 00:00,221810,458625,115684,677922,240730,1714771,0.129352549,0.267455538,0.067463236,0.395342585,0.140386092,1714771,0,811687,2526458,0.678725314,0,0.321274686
Sun 00:30,221810,458625,115684,677922,240730,1714771,0.129352549,0.267455538,0.067463236,0.395342585,0.140386092,1714771,0,811687,2526458,0.678725314,0,0.321274686
Sun 01:00,221810,458625,115419,677922,240730,1714506,0.129372542,0.267496877,0.067319099,0.395403691,0.140407791,1714506,0,811952,2526458,0.678620424,0,0.321379576
Sun 01:30,221810,458625,115419,677922,240730,1714506,0.129372542,0.267496877,0.067319099,0.395403691,0.140407791,1714506,0,811952,2526458,0.678620424,0,0.321379576
Sun 02:00,221810,458625,115401,677922,240730,1714488,0.129373901,0.267499685,0.067309308,0.395407842,0.140409265,1714488,0,811970,2526458,0.6786133,0,0.3213867
Sun 02:30,221810,458625,115401,677922,240730,1714488,0.129373901,0.267499685,0.067309308,0.395407842,0.140409265,1714488,0,811970,2526458,0.6786133,0,0.3213867
Sun 03:00,221810,458695,115403,677922,240730,1714560,0.129368468,0.267529279,0.067307647,0.395391237,0.140403369,1714560,0,811898,2526458,0.678641798,0,0.321358202
Sun 03:30,221810,458695,115403,677922,240730,1714560,0.129368468,0.267529279,0.067307647,0.395391237,0.140403369,1714560,0,811898,2526458,0.678641798,0,0.321358202
Sun 04:00,221986,458751,115417,677922,240730,1714806,0.129452544,0.267523557,0.067306156,0.395334516,0.140383227,1714806,0,811652,2526458,0.678739168,0,0.321260832
Sun 04:30,221986,458751,115417,677922,240730,1714806,0.129452544,0.267523557,0.067306156,0.395334516,0.140383227,1714806,0,811652,2526458,0.678739168,0,0.321260832
Sun 05:00,222147,458793,115431,678524,240725,1715620,0.129484968,0.267421107,0.067282382,0.395497838,0.140313706,1715620,0,810838,2526458,0.679061358,0,0.320938642
Sun 05:30,222147,458793,115431,678524,240725,1715620,0.129484968,0.267421107,0.067282382,0.395497838,0.140313706,1715620,0,810838,2526458,0.679061358,0,0.320938642
Sun 06:00,222160,458810,116395,679255,240940,1717560,0.129346282,0.26712895,0.067767647,0.395476723,0.140280398,1717560,0,808898,2526458,0.679829231,0,0.320170769
Sun 06:30,222160,458810,116395,679255,240954,1717574,0.129345228,0.267126773,0.067767095,0.395473499,0.140287405,1717574,0,808884,2526458,0.679834773,0,0.320165227
Sun 07:00,217387,449171,112388,671454,238822,1689222,0.128690604,0.265904067,0.066532404,0.397493047,0.141379878,1689222,0,837236,2526458,0.668612738,0,0.331387262
Sun 07:30,217387,449141,112391,671419,238830,1689168,0.128694718,0.265894807,0.066536307,0.397485034,0.141389134,1689168,0,837290,2526458,0.668591364,0,0.331408636
Sun 08:00,217301,448803,111986,671270,238870,1688230,0.128715282,0.265842332,0.066333379,0.397617623,0.141491384,1688230,0,838228,2526458,0.668220093,0,0.331779907
Sun 08:30,217294,448781,111986,671263,238870,1688194,0.12871388,0.265834969,0.066334793,0.397621956,0.141494402,1688194,0,838264,2526458,0.668205844,0,0.331794156
Sun 09:00,217291,448771,111991,671161,238868,1688082,0.128720643,0.265846683,0.066342156,0.397587913,0.141502605,1688082,0,838376,2526458,0.668161513,0,0.331838487
Sun 09:30,217291,448779,111991,671161,238868,1688090,0.128720033,0.265850162,0.066341842,0.397586029,0.141501934,1688090,0,838368,2526458,0.66816468,0,0.33183532
Sun 10:00,217288,448770,112133,671113,238882,1688186,0.128710936,0.265829713,0.066422183,0.397534987,0.14150218,1688186,0,838272,2526458,0.668202677,0,0.331797323
Sun 10:30,217288,448771,112134,671104,238882,1688179,0.12871147,0.265831408,0.066423051,0.397531304,0.141502767,1688179,0,838279,2526458,0.668199907,0,0.331800093
Sun 11:00,217284,448767,112134,671195,238882,1688262,0.128702772,0.265815969,0.066419786,0.397565662,0.14149581,1688262,0,838196,2526458,0.668232759,0,0.331767241
Sun 11:30,217284,448767,112134,671195,238882,1688262,0.128702772,0.265815969,0.066419786,0.397565662,0.14149581,1688262,0,838196,2526458,0.668232759,0,0.331767241
Sun 12:00,217284,448765,112134,671200,238882,1688265,0.128702544,0.265814312,0.066419668,0.397567917,0.141495559,1688265,0,838193,2526458,0.668233946,0,0.331766054
Sun 12:30,217284,448765,112134,671200,238882,1688265,0.128702544,0.265814312,0.066419668,0.397567917,0.141495559,1688265,0,838193,2526458,0.668233946,0,0.331766054
Sun 13:00,217285,448795,111946,671200,238882,1688108,0.128715106,0.265856805,0.066314478,0.397604893,0.141508719,1688108,0,838350,2526458,0.668171804,0,0.331828196
Sun 13:30,217285,448795,111946,671200,238882,1688108,0.128715106,0.265856805,0.066314478,0.397604893,0.141508719,1688108,0,838350,2526458,0.668171804,0,0.331828196
Sun 14:00,217285,448795,111946,671156,238868,1688050,0.128719528,0.26586594,0.066316756,0.397592488,0.141505287,1688050,0,838408,2526458,0.668148847,0,0.331851153
Sun 14:30,217285,448795,111946,671156,238868,1688050,0.128719528,0.26586594,0.066316756,0.397592488,0.141505287,1688050,0,838408,2526458,0.668148847,0,0.331851153
Sun 15:00,217289,448794,111922,671156,238891,1688052,0.128721746,0.265865033,0.06630246,0.397592017,0.141518745,1688052,0,838406,2526458,0.668149639,0,0.331850361
Sun 15:30,217289,448794,111922,671156,238891,1688052,0.128721746,0.265865033,0.06630246,0.397592017,0.141518745,1688052,0,838406,2526458,0.668149639,0,0.331850361
Sun 16:00,221905,456815,114855,678667,240922,1713164,0.129529339,0.266649895,0.067042618,0.396148296,0.140629852,1713164,0,813294,2526458,0.678089246,0,0.321910754
Sun 16:30,221905,456823,114855,678667,240922,1713172,0.129528734,0.266653319,0.067042305,0.396146446,0.140629195,1713172,0,813286,2526458,0.678092412,0,0.321907588
Sun 17:00,221992,457256,114965,678850,240939,1714002,0.129516768,0.266776818,0.067074017,0.396061381,0.140571015,1714002,0,812456,2526458,0.678420936,0,0.321579064
Sun 17:30,221992,457257,114965,678850,240939,1714003,0.129516693,0.266777246,0.067073978,0.39606115,0.140570932,1714003,0,812455,2526458,0.678421331,0,0.321578669
Sun 18:00,222046,457747,115294,678939,240956,1714982,0.129474245,0.266910673,0.067227528,0.395886954,0.1405006,1714982,0,811476,2526458,0.67880883,0,0.32119117
Sun 18:30,222046,457747,115294,678939,240956,1714982,0.129474245,0.266910673,0.067227528,0.395886954,0.1405006,1714982,0,811476,2526458,0.67880883,0,0.32119117
Sun 19:00,222117,458725,115920,679291,241040,1717093,0.129356418,0.2671521,0.067509448,0.395605247,0.140376788,1717093,0,809365,2526458,0.679644388,0,0.320355612
Sun 19:30,222117,458725,115920,679291,241040,1717093,0.129356418,0.2671521,0.067509448,0.395605247,0.140376788,1717093,0,809365,2526458,0.679644388,0,0.320355612
Sun 20:00,222117,458785,115929,679401,240974,1717206,0.129347906,0.26716946,0.067510246,0.395643272,0.140329116,1717206,0,809252,2526458,0.679689114,0,0.320310886
Sun 20:30,222117,458785,115929,679401,240974,1717206,0.129347906,0.26716946,0.067510246,0.395643272,0.140329116,1717206,0,809252,2526458,0.679689114,0,0.320310886
Sun 21:00,222119,458746,115937,678576,240974,1716352,0.12941343,0.267279672,0.067548498,0.39535946,0.140398939,1716352,0,810106,2526458,0.679351092,0,0.320648908
Sun 21:30,222119,458746,115937,678576,240974,1716352,0.12941343,0.267279672,0.067548498,0.39535946,0.140398939,1716352,0,810106,2526458,0.679351092,0,0.320648908
Sun 22:00,221989,458636,116056,677995,240829,1715505,0.129401546,0.267347516,0.067651216,0.395215986,0.140383735,1715505,0,810953,2526458,0.67901584,0,0.32098416
Sun 22:30,221989,458636,116056,677995,240829,1715505,0.129401546,0.267347516,0.067651216,0.395215986,0.140383735,1715505,0,810953,2526458,0.67901584,0,0.32098416
Sun 23:00,221989,458635,115382,677942,240730,1714678,0.129463958,0.267475876,0.067290768,0.395375692,0.140393707,1714678,0,811780,2526458,0.678688504,0,0.321311496
Sun 23:30,221989,458635,115382,677942,240730,1714678,0.129463958,0.267475876,0.067290768,0.395375692,0.140393707,1714678,0,811780,2526458,0.678688504,0,0.321311496
