yearmonth,George_Washington_Bridge,Lincoln_Tunnel,Holland_Tunnel,Goethals_Bridge,Outerbridge_Crossing,Bayonne_Bridge,Total
201101,3695684,1487813,1236450,1013561,1053365,262283,8749156
201102,3587374,1453817,1226770,1000142,1039569,257419,8565091
201103,4221447,1711098,1435707,1168410,1208881,302679,10048222
201104,4255625,1704764,1403554,1166681,1215639,300070,10046333
201105,4483446,1744676,1457144,1249166,1297228,313124,10544784
201106,4474718,1729257,1447245,1249564,1315660,314230,10530674
201107,4646097,1713646,1469957,1325269,1357849,306207,10819025
201108,4415798,1663648,1391267,1255443,1281346,301245,10308747
201109,4195808,1638207,1347191,1198164,1225084,297538,9901992
201110,4145059,1686179,1391174,1186503,1217997,294054,9920966
201111,4101174,1624250,1360280,1169558,1175896,290553,9721711
201112,4175177,1672079,1422961,1195988,1229855,297024,9993084
201201,3781788,1510709,1287761,1061906,1106579,277750,9026493
201202,3716610,1464800,1258525,1039786,1086885,271941,8838547
201203,4124500,1634450,1408648,1148825,1197527,299551,9813501
201204,4134467,1633764,1365421,1166113,1197886,293024,9790675
201205,4348902,1652937,1440753,1216872,1261677,308448,10229589
201206,4298201,1624182,1424569,1230779,1291571,303953,10173255
201207,4276079,1609256,1421140,1277963,1310687,299695,10194820
201208,4422202,1641481,1444077,1296117,1343245,312325,10459447
201209,4070506,1561978,1348588,1153291,1202396,283566,9620325
201210,3949978,1556431,1272003,1091633,1131840,279714,9281599
201211,3892052,1520182,1046097,1153915,1148408,280807,9041461
201212,4095636,1604865,1399951,1166420,1227962,287728,9782562
201301,3830276,1474388,1283310,1068959,1125764,279932,9062629
201302,3426080,1325372,1157853,947736,1000685,249747,8107473
201303,4065855,1587688,1369232,1134529,1192967,283081,9633352
201304,4112127,1565983,1355016,1123174,1193917,288071,9638288
201305,4343637,1634667,1409980,1182806,1264417,302573,10138080
201306,4291856,1597360,1386529,1186320,1278407,293505,10033977
201307,4465522,1579328,1403023,1309880,1188235,299264,10245252
201308,4500807,1655961,1406358,1368812,1200648,307269,10439855
201309,4098852,1562146,1323592,1240948,1062572,286315,9574425
201310,4270770,1634586,1396817,1240313,1117240,301657,9961383
201311,4016385,1559777,1326572,1122564,1112196,282641,9420135
201312,3980077,1568694,1339287,1140219,1138312,266325,9432914
201401,3569088,1409508,1182062,975666,998439,236061,8370824
201402,3172907,1277459,1061542,876723,899500,207434,7495565
201403,4003444,1574585,1314376,1099805,1123228,247515,9362953
201404,4118130,1594801,1276855,1156609,1158505,240789,9545689
201405,4412253,1666298,1360976,1249255,1239181,230416,10158379
201406,4247633,1635328,1347706,1226958,1246114,249395,9953134
201407,4366984,1603049,1366826,1270819,1279123,250536,10137337
201408,4503805,1643217,1397065,1318147,1324550,215960,10402744
201409,4141635,1576301,1313770,1184505,1182443,215817,9614471
201410,4246759,1658428,1339190,1193422,1190251,243349,9871399
201411,4063038,1548544,1278995,1139796,1130360,207807,9368540
201412,4190613,1603447,1331235,1184769,1193810,232744,9736618
201501,3613894,1401488,1146262,1025364,1018022,198710,8403740
201502,3376558,1344534,1103138,979080,943618,166023,7912951
201503,3962433,1582276,1258086,1139980,1109119,194723,9246617
201504,4186615,1596498,1302519,1218600,1185048,167765,9657045
201505,4465676,1669186,1375465,1255932,1292734,191820,10250813
201506,4387567,1610822,1330957,1244082,1282536,181418,10037382
201507,4622590,1614447,1354588,1334481,1321375,169705,10417186
201508,4721645,1659999,1364192,1343397,1372381,160308,10621922
201509,4247572,1555832,1262846,1252046,1218191,161798,9698285
201510,4364137,1674385,1329328,1299405,1235862,149906,10053023
201511,4199613,1590190,1267025,1263763,1191523,148348,9660462
201512,4308497,1631931,1314614,1307038,1258111,167150,9987341
201601,3719694,1420012,1143834,1120404,1079561,129334,8612839
201602,3741641,1451290,1154912,1126553,1082731,124720,8681847
201603,4271470,1630407,1307874,1287266,1238581,145374,9880972
201604,4214925,1604089,1290454,1292835,1239590,128212,9770105
201605,4466486,1687954,1337951,1376413,1309716,147981,10326501
201606,4446971,1646940,1307961,1374100,1347362,139225,10262559
201607,4666357,1643870,1324314,1428957,1394180,121084,10578762
201608,4763470,1658698,1329611,1434492,1412729,135982,10734982
201609,4366695,1594523,1274144,1313677,1284812,132910,9966761
201610,4414346,1657184,1317156,1303599,1306641,144614,10143540
201611,4245113,1586461,1317156,1276940,1241045,164979,9785758
201612,4313273,1629491,1305930,1316571,1294487,166993,10026745
201701,3950784,1479737,1171765,1202508,1159905,137495,9102194
201702,3634905,1387010,1081274,1134782,1086744,122429,8447144
201703,4062892,1548623,1202299,1228811,1218530,172505,9433660
201704,4318938,1608477,1232657,1308801,1300541,193946,9963360
201705,4493279,1647122,1271683,1369561,1331365,220123,10333133
201706,4486650,1634891,1271115,1326189,1403174,240046,10362065
201707,4688669,1619943,1288208,1426336,1431282,197634,10652072
201708,4744720,1649198,1299780,1453376,1439517,218735,10805326
201709,4347181,1610040,1247725,1353060,1316205,197682,10071893
201710,4423487,1662992,1297407,1364580,1334252,212596,10295314
201711,4285938,1582289,1240604,1306292,1264972,217591,9897686
201712,4282644,1608888,1267026,1339165,1301480,231341,10030544
201801,3871359,1467644,1133249,1165265,1157212,221407,9016136
201802,3683941,1385630,1083022,1144772,1085164,197449,8579978
201803,4104040,1573439,1221060,1277638,1207349,221336,9604862
201804,4275331,1605337,1217665,1347937,1276282,223598,9946150
201805,4527996,1657619,1303068,1391407,1346432,263953,10490475
201806,4534633,1632375,1297741,1394377,1378805,284046,10521977
201807,4601082,1639848,1304644,1526011,1384088,235085,10690758
201808,4695184,1624844,1327294,1561510,1401026,260558,10870416
201809,4281397,1574976,1261964,1414861,1267688,232294,10033180
201810,4384187,1652776,1335361,1478759,1286469,241842,10379394
201811,4176934,1555649,1255408,1412225,1215941,234599,9850756
201812,4368600,1589869,1330588,1462778,1283285,238527,10273647
201901,3920647,1438391,1209966,1326867,1143834,202396,9242101
201902,3677566,1357207,1128086,1244714,1069614,191748,8668935
201903,4241762,1585107,1266571,1431155,1229237,248778,10002610
201904,4278887,1567347,1300323,1492767,1239935,219997,10099256
201905,4511523,1628922,1362005,1550624,1304329,295167,10652570
201906,4504891,1584281,1330235,1552833,1309411,302228,10583879
201907,4655381,1536618,1330571,1585402,1336098,308588,10752658
201908,4712338,1609042,1357102,1606482,1365593,325927,10976484
201909,4333042,1576712,1313449,1469194,1281867,315625,10289889
201910,4439508,1588721,1367121,1493013,1279201,317235,10484799
201911,4331476,1522676,1312946,1425892,1241748,308973,10143711
201912,4353941,1539284,1356034,1486423,1277033,318069,10330784
202001,4063426,1432628,1250810,1373385,1177020,280005,9577274
202002,3939733,1393271,1221499,1338786,1124163,266860,9284312
202003,3121055,1026043,909070,1061686,894861,222456,7235171
202004,1788278,477458,445082,575424,538947,139765,3964954
202005,2822993,726692,689010,901309,823950,192345,6156299
202006,3538604,972034,837446,1174939,1066783,235439,7825245
202007,4045269,1174071,971196,1361413,1201538,259010,9012497
202008,4156713,1311846,1043546,1432570,1253091,273843,9471609
202009,3952200,1301439,1023213,1374221,1192707,268193,9111973
202010,4017151,1387270,1067144,1334297,1208797,295202,9309861
202011,3680223,1236769,985005,1289189,1058353,253603,8503142
202012,3616544,1243134,996097,1252335,1027063,241598,8376771
202101,3598788,1196872,989988,1227474,1011533,234965,8259620
202102,3083196,1032133,845360,1035230,840209,197916,7034044
202103,4012394,1400125,1111118,1352009,1113919,258596,9248161
202104,4008591,1452684,1120903,1378093,1156266,269080,9385617
202105,4354080,1544681,1203078,1477971,1266023,311412,10157245
202106,4398152,1591763,1236678,1500682,1307649,336332,10371256
202107,4626275,1604648,1234735,1572358,1316647,330634,10685297
202108,4571841,1606606,1246009,1585296,1302183,340005,10651940
202109,4128656,1587710,1224037,1470208,1192822,328987,9932420
202110,4240306,1699251,1297801,1528612,1263570,361670,10391210
202111,4154044,1610170,1261555,1468645,1196797,346386,10037597
202112,4096017,1575033,1250311,1477357,1184130,316059,9898907
